*...##.............~
.##.#..####.######.~
....#.~...#..#...#.~
..#.#...~.#.~#.~...#
#.#.#####.#..#.###..
..#.......##.....#~.
.~#~.#~.###....~.#..
...~.#...#..###....#
.#...#.#@#....####..
.##.##.####+.....#~.
.~#.....+####.##.##.
..####....#x#.#...#.
#....###..#...#.~...
..#.~.#..###.~#.~#~.
.~#.....##.......#..
..###.#..#.#####.#.#
#...~.#~.#.~...#.#..
~.#...#..#...~.#....
~.######.####..#.##.
~.............##...*