######~~#~~#.....#####........
#....~.....#.###.#...~~.####~.
#.~#.#.~##.#...#...#.~.....#..
#..#.#...#.###.#.###.#####.#.~
#~.#.###.#...#.~.#...#...#.#.~
#..#...#.###.#.~.#.~~#.#.#.#..
#.####.#...#.#.~.#.....#.#.#~.
#....#.###.#.#.#.#######.#.#~.
####.#..#..#.#.#.......#...#..
.....##...##.#.#######.#####.~
.###.~#...#*....#....#...#.~.#
.#...~#...#####...~~.#~~.....#
...#####.##...##~.~..#...###.#
.###....+#~.#..##.#.##.###...#
.....#.###..##....#.#..#...###
##~~##..#~.~###..##.#.##....+#
.....#..#~.~#x#..#..#.#..#...~
.###.#~.#..##.#~##.##.#.##.#.~
##......#.~#..#~#..#..#....#..
#..######.##.####.~#.#######.#
#.##......#....##....#.......#
#....#.####.##..####.#.###.###
#.~#.#.#.....##...#..#...#....
#..#.#...#.~..#.#.~.##.#.####.
##.#.#####...##.#...#..#...#..
.#.#.~...##.##..#####.##.#.#.~
...#...#.....#.~...#..#~.#.#..
.#############...~.~.##~.#.##.
.~~~#...~#...####~.~.~...#@...
+...#.~..#.#.......#.~.~.###.~
~~#...~~...#########...~......
