....###.......#
.##.......+.###
@...~~.#.#..##.
.##.~~.#....#..
..####.###.##..
.##..###.#..#.x
.........#..#..
.##..~~~.#..##.
..............*
..~~.###.#.###.
.....#*..#...#.
######.#.#.#...
..............~
###.##..~~...~~
..#..#.#..###..