@####.~.###....
.#+.......#.##.
.....#..#...#..
.#.#.#.######~.
.#.#...#...~#~.
.#####.#.~..#..
.....#...##.#.~
##.~.#.###..#..
.#.~...#...###.
.#...#...###.~.
...*##.#..#*...
.####..##.##.#.
....#~..#.~#.#.
~~~.###.#..#.#.
###.....#~...#x