#######~....~##
#~#...##.~#.##~
#...~.....#....
..#..#~~~.####.
.###.###.....#.
..@#...#.#*....
##.#.#...#.##..
#~.#.#.#.###*..
*....#.#.#..##.
.###.#.#....#~.
.#~###.###~....
.#.......~~.#~.
...#####....#..
.###...#.####.~
.....~...#x...~