~.........#...#.~~##
.x###.###.#.#.#.~...
.##*...#....#.....#.
.#*.~#.#.~#.###...#.
.#.~##.#.~#.#~....#.
...##~.#..#.#..####.
.#.......##...##....
.#####.~..#...#..~.#
.#......~.###...#..#
......#...~.#####.##
##.#####.~...#.~~...
#..#...###.~......#.
#.~..#...#..~.#####.
....##.~.##.......#.
.####..#.#..#.~##...
.#~...~#.#~.#.##~.#.
.#~..###.#~.#.#~.*#.
.#.....#....#...*##.
...~.#.#.#.###.###@.
##~~.#...#.........~
