~.........#...#.~~##
.x###.###.#.#.#.~...
.##*...#....#.....#.
.#~.~#.#.~#.###...#.
.#.~##.#.~#.#~....#.
...##~.#..#.#..####.
.#+......##...##....
.#####.~..#...#..~.#
.#......~.###...#..#
......#...~.#####.##
##.#####.~...#.~~...
#..#...###.~......#.
#.~..#...#..~.#####.
....##.~.##......+#.
.####..#.#..#.~##...
.#~...~#.#~.#.##~.#.
.#~..###.#~.#.#~.~#.
.#.....#....#...*##.
...~.#.#.#.###.###@.
##~~.#...#.........~
