###....#...........*
#x..~~.#.####.~###.#
#.####...#~~####...#
#....#####.......~##
##~~.#....~.#.##....
~#~~.#.~#...#..###~.
+......~##.###..~#..
.#.######~...##.~#.~
.#..#~...~.#.~#..#.#
.##.#~.#...#..##.#..
..#.##.#####..~#.##.
#.#..#..#.....~#..#.
~.#~.##...~######.#.
..#~..###.##~......+
.~###..#...#~.#.~~#~
....##.#.~....#.~~##
##~.......#####....#
#...####~~#...####.#
#.###~.####.#.~~..@#
*...........#....###
