###....#...........*
#x..~~.#.####.~###.#
#.####...#~~####...#
#....#####.......~##
##~~.#....~.#.##....
*#~~.#.~#...#..###~.
.......~##.###..~#..
.#.######~...##.~#.~
.#..#~...~.#.~#..#.#
.##.#~.#...#..##.#..
..#.##.#####..~#.##.
#.#..#..#.....~#..#.
~.#~.##...~######.#.
..#~..###.##~.......
.~###..#...#~.#.~~#*
....##.#.~....#.~~##
##~.......#####....#
#...####~~#...####.#
#.###~.####.#.~~..@#
*...........#....###
