######~~#~~#.....#####........
#....~.....#.###.#...~~.####~.
#.~#.#.~##.#...#...#.~.....#..
#..#.#...#.###.#.###.#####.#.~
#~.#.###.#...#.~.#...#...#.#.~
#..#...#.###.#.~.#.~~#.#.#.#..
#.####.#...#.#.~.#.....#.#.#~.
#....#.###.#.#.#.#######.#.#~.
####.#..#..#.#.#.......#...#..
.....##...##.#.#######.#####.~
.###.~#...#*....#....#...#.~.#
.#...~#...#####...~~.#~~.....#
...#####.##...##~.~..#...###.#
.###....+#~.#..##.#.##.###..+#
.....#.###..##....#.#..#...###
##~~##..#~.~###..##.#.##.###~#
.....#..#~.~#....#..#.#..#...~
.###.#~.#..##.#~##.##.#.##.#.~
##......#.~#..#~#..#..#....#..
#..######.##.####.~#.#######.#
#.##......#....##....#.......#
#....#.####.##..####.#.###.###
#.~#.#.#.....##...#..#...#....
#..#.#...#.~.@#.#.~.##.#.####.
##.#.#####...##.#...#..#...#..
.#.#.~...##.##..#####.##.#.#.~
...#...#.....#.~...#..#~.#.#..
.#############...~.~.##~.#.##.
.~~~#...~#...####~.~.~...#x...
....#.~..#.#.......#.~.~.###.~
.~#...~~...#########...*......
