######~~#~~#.....#####*.......
#....~*....#.###.#...~~.####~.
#.~#.#.~##.#...#...#.~.....#..
#..#.#...#.###.#.###.#####.#.~
#~.#.###.#...#.~.#...#...#.#.~
#..#...#.###.#.~.#.~~#.#.#.#..
#.####.#...#.#.~.#.....#.#.#~.
#....#.###.#.#.#.#######.#.#~.
####.#..#..#.#.#.......#...#..
.....##...##.#.#######.#####.~
.###.~#...#*....#....#...#.~.#
.#...~#...#####...~~.#~~.....#
...#####.##...##~.~..#...###.#
.###...#*#~.#..##.#.##.###...#
.....#.###..#~....#.#..#...###
##~~##..#~.~~~~..##.#.##.###~#
.....#..#~.~#....#..#.#..#...~
.###.#~.#..##.#.##.##.#.##.#.~
##......#.~#..#x#..#..#....#..
#..######.##.####.~#.#######.#
#.##......#....##....#.......#
#....#.####.##..####.#.###.###
#.~#.#.#.....##...#..#...#....
#..#.#...#.~.~#.#.~.##.#.####.
##.#.#####...##.#...#..#...#..
.#.#.~...##.##..#####.##.#.#.~
...#...#.....#.~...#..#~.#.#..
.#############...~.~.##~.#.##.
.~~~#...~#...####~.~.~...#@...
....#.~..#.#.......#.~.~.###.~
*~#...~~...#########...~......
