######~~#~~#.....#####........
#....~.....#.###.#...~~.####~.
#.~#.#.~##.#...#...#.~.....#..
#..#.#...#.###.#.###.#####.#.~
#~.#.###.#...#.~.#...#...#.#.~
#..#...#.###.#.~.#.~~#.#.#.#..
#.####.#...#.#.~.#.....#.#.#~.
#....#.###.#.#.#.#######.#.#~.
####.#..#..#.#.#.......#...#..
.....##...##.#.#######.#####.~
.###.~#...#*....#....#...#.~.#
.#...~#...#####...~~.#~~.....#
...#####.##...##~.~..#...###.#
.###...#*#~.#..##.#.##.###...#
.....#.###..#~....#.#..#...###
##~~##..#~.~~~~..##.#.##.###~#
.....#..#~.~#....#..#.#..#...~
.###.#~.#..##.#.##.##.#.##.#.~
##......#.~#..#@#..#..#....#..
#..######.##.####.~#.#######.#
#.##......#....##....#.......#
#....#.####.##..####.#.###.###
#.~#.#.#.....##...#..#...#....
#..#.#...#.~.~#.#.~.##.#.####.
##.#.#####...##.#...#..#...#..
.#.#.~...##.##..#####.##.#.#.~
...#...#.....#.~...#..#~.#.#..
.#############...~.~.##~.#.##.
.~~~#...~#...####~.~.~...#x...
....#.~..#.#.......#.~.~.###.~
*~#...~~...#########...~......
